w w w w w w w w w w w w w w w w w w w w w
w                                       w
w                                       w
w                                       w
w                                       w
w         w                   w         w
w                                       w
w                                       w
w                   p                   w
w                                       w
w     l             c             s     w
w                                       w
w                                       w
w                                       w
w         w                   w         w
w                                       w
w                                       w
w                   b                   w
w                                       w
w                                       w
w w w w w w w w w w w w w w w w w w w w w 