wwwwwwwwwwwwwww
w.............w
w.s....b....s.w
w...w.....w...w
w.............w
ww.....w.....ww
www...www...www
ww.....w.....ww
w.............w
w.l.w..s..w.l.w
w.............w
ww.....w.....ww
www...www...www
ww.....w.....ww
w.............w
w...w..l..w...w
w.............w
w.............w
w.............w
w...wwwwwww...w
w.............w
w.............w
w.............w
wwwwww...wwwwww
w.............w
w.............w
w..ww..c..ww..w
w...w.....w...w
w......p......w
w.............w
wwwwwwwwwwwwwww